9 9 9 9 9 9 9 9 9 9 9 9 9 9 9 9 9 9 9 9 9 9 9 9 9 9 9 9 9 9 9 9 9 9 9 9 9 9 9 9 9 9 9 9 9 9
9 3 3 0 0 0 0 0 0 0 0 0 0 0 0 0 0 0 0 0 0 0 0 0 0 0 0 0 0 0 0 0 0 0 0 0 0 0 0 0 0 0 0 3 3 9
9 3 3 0 0 0 0 0 0 0 0 0 0 0 0 0 0 0 0 0 0 0 0 0 0 0 0 0 0 0 0 0 0 0 0 0 0 0 0 0 0 0 0 3 3 9
9 0 0 0 0 0 0 0 0 0 0 0 0 3 0 0 0 0 0 0 0 0 0 0 0 0 0 0 0 0 0 0 3 0 0 0 0 0 0 0 0 0 0 0 0 9
9 0 0 0 8 8 8 8 8 8 8 8 0 0 0 0 0 0 0 0 0 0 0 0 0 0 0 0 0 0 0 3 0 0 8 8 8 8 8 8 8 8 0 0 0 9
9 0 0 0 8 8 8 8 8 8 8 8 0 0 0 3 0 0 0 0 0 0 0 0 0 0 0 0 0 0 3 0 0 0 8 8 8 8 8 8 8 8 0 0 0 9
9 0 0 0 8 8 7 7 7 7 8 8 0 0 0 0 3 0 0 0 0 0 0 0 0 0 0 0 0 3 0 0 0 0 8 8 7 7 7 7 8 8 0 0 0 9
9 0 0 0 8 8 7 7 7 7 8 8 0 0 0 0 0 3 0 0 0 0 0 0 0 0 0 0 3 0 0 0 0 0 8 8 7 7 7 7 8 8 0 0 0 9
9 0 0 0 8 8 7 7 7 7 8 8 0 0 0 0 0 0 3 3 3 3 3 3 3 3 3 3 0 0 0 0 0 0 8 8 7 7 7 7 8 8 0 0 0 9
9 0 0 0 8 8 7 7 7 7 8 8 0 0 0 0 0 0 0 0 0 0 3 3 0 0 0 0 0 0 0 0 0 0 8 8 7 7 7 7 8 8 0 0 0 9
9 0 0 0 8 8 8 8 8 8 8 8 0 0 0 0 0 0 0 0 0 0 3 3 0 0 0 0 0 0 0 0 0 0 8 8 8 8 8 8 8 8 0 0 0 9
9 0 0 0 8 8 8 8 8 8 8 8 0 0 0 0 0 0 0 0 0 0 6 6 0 0 0 0 0 0 0 0 0 0 8 8 8 8 8 8 8 8 0 0 0 9
9 0 0 0 0 0 0 0 0 0 0 0 0 0 0 0 0 0 0 0 0 0 6 6 0 0 0 0 0 0 0 0 0 0 0 0 0 0 0 0 0 0 0 0 0 9
9 0 0 0 0 0 0 0 0 0 0 0 6 6 6 8 8 8 8 8 8 8 6 6 8 8 8 8 8 8 8 6 6 6 0 0 0 0 0 0 0 0 0 0 0 9
9 0 0 0 0 0 0 0 0 0 6 6 6 8 0 0 0 0 0 0 0 0 8 8 0 0 0 0 0 0 0 0 0 6 6 6 0 0 0 0 0 0 0 0 0 9
9 0 0 0 0 0 0 0 0 0 0 0 6 6 6 8 8 8 8 8 8 8 6 6 8 8 8 8 8 8 8 6 6 6 0 0 0 0 0 0 0 0 0 0 0 9
9 0 0 0 0 0 0 0 0 0 0 0 0 0 0 0 0 0 0 0 0 0 6 6 0 0 0 0 0 0 0 0 0 0 0 0 0 0 0 0 0 0 0 0 0 9
9 0 0 0 8 8 8 8 8 8 8 8 0 0 0 0 0 0 0 0 0 0 6 6 0 0 0 0 0 0 0 0 0 0 8 8 8 8 8 8 8 8 0 0 0 9
9 0 0 0 8 8 8 8 8 8 8 8 0 0 0 0 0 0 0 0 0 0 3 3 0 0 0 0 0 0 0 0 0 0 8 8 8 8 8 8 8 8 0 0 0 9
9 0 0 0 8 8 7 7 7 7 8 8 0 0 0 0 0 0 0 0 0 0 3 3 0 0 0 0 0 0 0 0 0 0 8 8 7 7 7 7 8 8 0 0 0 9
9 0 0 0 8 8 7 7 7 7 8 8 0 0 0 0 0 0 3 3 3 3 3 3 3 3 3 3 0 0 0 0 0 0 8 8 7 7 7 7 8 8 0 0 0 9
9 0 0 0 8 8 7 7 7 7 8 8 0 0 0 0 0 3 0 0 0 0 0 0 0 0 0 0 3 0 0 0 0 0 8 8 7 7 7 7 8 8 0 0 0 9
9 0 0 0 8 8 7 7 7 7 8 8 0 0 0 0 3 0 0 0 0 0 0 0 0 0 0 0 0 3 0 0 0 0 8 8 7 7 7 7 8 8 0 0 0 9
9 0 0 0 8 8 8 8 8 8 8 8 0 0 0 3 0 0 0 0 0 0 0 0 0 0 0 0 0 0 3 0 0 0 8 8 8 8 8 8 8 8 0 0 0 9
9 0 0 0 8 8 8 8 8 8 8 8 0 0 3 0 0 0 0 0 0 0 0 0 0 0 0 0 0 0 0 3 0 0 8 8 8 8 8 8 8 8 0 0 0 9
9 0 0 0 0 0 0 0 0 0 0 0 0 3 0 0 0 0 0 0 0 0 0 0 0 0 0 0 0 0 0 0 3 0 0 0 0 0 0 0 0 0 0 0 0 9
9 3 3 0 0 0 0 0 0 0 0 0 0 0 0 0 0 0 0 0 0 0 0 0 0 0 0 0 0 0 0 0 0 0 0 0 0 0 0 0 0 0 0 3 3 9
9 3 3 0 0 0 0 0 0 0 0 0 0 0 0 0 0 0 0 0 0 0 0 0 0 0 0 0 0 0 0 0 0 0 0 0 0 0 0 0 0 0 0 3 3 9
9 9 9 9 9 9 9 9 9 9 9 9 9 9 9 9 9 9 9 9 9 9 9 9 9 9 9 9 9 9 9 9 9 9 9 9 9 9 9 9 9 9 9 9 9 9